//MAP CONVERTED BY dmm2tgm.py THIS HEADER COMMENT PREVENTS RECONVERSION, DO NOT REMOVE
"a" = (
/obj/machinery/door/poddoor,
/turf/simulated/floor/plating/airless,
/area/ruin/powered)
"b" = (
/obj/machinery/light/small,
/turf/simulated/floor/mineral/titanium/blue,
/area/ruin/powered)
"c" = (
/obj/machinery/door/poddoor/preopen,
/turf/simulated/floor/plating/airless,
/area/ruin/powered)
"g" = (
/obj/structure/table,
/obj/effect/spawner/random/food_or_drink/dinner,
/turf/simulated/floor/mineral/titanium/blue,
/area/ruin/powered)
"q" = (
/obj/machinery/door/airlock/public/glass,
/turf/simulated/floor/mineral/titanium/blue,
/area/ruin/powered)
"s" = (
/obj/structure/chair/comfy/shuttle{
	dir = 1
	},
/turf/simulated/floor/mineral/titanium/blue,
/area/ruin/powered)
"z" = (
/turf/simulated/floor/pod/light/airless,
/area/ruin/powered)
"H" = (
/obj/structure/bed,
/obj/item/bedsheet/black,
/obj/structure/curtain/black,
/turf/simulated/floor/mineral/titanium/blue,
/area/ruin/powered)
"K" = (
/obj/machinery/door/airlock/external,
/turf/simulated/floor/plating/airless,
/area/ruin/powered)
"N" = (
/obj/structure/window/full/shuttle,
/turf/simulated/floor/plating,
/area/ruin/powered)
"O" = (
/turf/simulated/wall/mineral/titanium,
/area/ruin/powered)
"Q" = (
/obj/effect/spawner/random/food_trash,
/turf/simulated/floor/mineral/titanium/blue,
/area/ruin/powered)
"V" = (
/turf/simulated/floor/catwalk/airless,
/area/ruin/powered)
"W" = (
/obj/machinery/computer/nonfunctional,
/turf/simulated/floor/mineral/titanium/blue,
/area/ruin/powered)
"Y" = (
/turf/template_noop,
/area/template_noop)
"Z" = (
/obj/effect/map_effect/marker/mapmanip/submap/insert/ruin/oxygen_ferry,
/turf/template_noop,
/area/template_noop)

(1,1,1) = {"
Y
Y
Y
Y
Y
Y
Y
Y
Y
Y
Y
Y
Y
Y
"}
(2,1,1) = {"
Y
Y
Y
Y
Y
O
O
O
O
O
Y
Y
Y
Y
"}
(3,1,1) = {"
Y
O
N
O
O
O
z
z
z
O
O
Y
Z
Y
"}
(4,1,1) = {"
Y
N
W
s
O
z
z
z
z
z
c
Y
Y
Y
"}
(5,1,1) = {"
Y
N
g
Q
q
V
V
V
V
V
K
Y
Y
Y
"}
(6,1,1) = {"
Y
N
H
b
O
z
z
z
z
z
a
Y
Y
Y
"}
(7,1,1) = {"
Y
O
N
O
O
O
z
z
z
O
O
Y
Y
Y
"}
(8,1,1) = {"
Y
Y
Y
Y
Y
O
O
O
O
O
Y
Y
Y
Y
"}
(9,1,1) = {"
Y
Y
Y
Y
Y
Y
Y
Y
Y
Y
Y
Y
Y
Y
"}
