//MAP CONVERTED BY dmm2tgm.py THIS HEADER COMMENT PREVENTS RECONVERSION, DO NOT REMOVE
"a" = (
/turf/template_noop,
/area/template_noop)
"b" = (
/obj/structure/railing{
	dir = 4
	},
/obj/structure/railing{
	dir = 8
	},
/obj/effect/spawner/random/dirt/frequent,
/turf/template_noop,
/area/template_noop)
"e" = (
/obj/effect/map_effect/marker_helper/mapmanip/submap/edge,
/turf/template_noop,
/area/template_noop)
"f" = (
/obj/structure/closet/emcloset,
/turf/template_noop,
/area/template_noop)
"h" = (
/obj/machinery/light/small{
	dir = 4
	},
/obj/structure/closet/crate/trashcart,
/obj/effect/spawner/random/trash,
/obj/effect/spawner/random/pool/spaceloot/syndicate/mixed,
/obj/effect/spawner/random/maintenance,
/obj/effect/spawner/random/dirt/frequent,
/turf/template_noop,
/area/template_noop)
"i" = (
/obj/machinery/light/small{
	dir = 4
	},
/obj/structure/shelf/engineering,
/obj/effect/spawner/random/engineering/misc,
/obj/effect/spawner/random/engineering/misc,
/turf/template_noop,
/area/template_noop)
"j" = (
/obj/machinery/light/small{
	dir = 8
	},
/obj/effect/spawner/random/supply_crate/emergency,
/turf/template_noop,
/area/template_noop)
"m" = (
/obj/structure/railing/cap,
/obj/structure/railing/cap/normal{
	dir = 1
	},
/obj/structure/railing/cap/normal,
/obj/structure/railing/cap,
/obj/structure/railing/cap{
	dir = 1
	},
/turf/template_noop,
/area/template_noop)
"n" = (
/obj/structure/shelf/medbay,
/obj/effect/spawner/random/medical,
/obj/effect/spawner/random/medical,
/turf/template_noop,
/area/template_noop)
"o" = (
/obj/machinery/light/small{
	dir = 8
	},
/obj/effect/spawner/random/supply_crate/medical,
/turf/template_noop,
/area/template_noop)
"p" = (
/obj/structure/railing{
	dir = 4
	},
/obj/structure/railing{
	dir = 8
	},
/turf/template_noop,
/area/template_noop)
"q" = (
/obj/effect/map_effect/marker/mapmanip/submap/extract/ruin/oxygen_ferry,
/obj/machinery/atmospherics/portable/canister/oxygen/broken,
/turf/template_noop,
/area/template_noop)
"r" = (
/obj/effect/spawner/random/supply_crate/emergency,
/turf/template_noop,
/area/template_noop)
"s" = (
/obj/structure/railing/cap,
/obj/structure/railing/cap/normal{
	dir = 1
	},
/obj/structure/railing/cap/normal,
/obj/structure/railing/cap,
/obj/structure/railing/cap{
	dir = 1
	},
/obj/effect/spawner/random/dirt/frequent,
/turf/template_noop,
/area/template_noop)
"t" = (
/obj/effect/spawner/random/supply_crate/engi_atmos,
/turf/template_noop,
/area/template_noop)
"v" = (
/obj/effect/spawner/random/supply_crate/janitorial,
/turf/template_noop,
/area/template_noop)
"w" = (
/obj/effect/decal/cleanable/glass,
/obj/effect/spawner/random/dirt/frequent,
/turf/template_noop,
/area/template_noop)
"y" = (
/obj/structure/shelf/engineering,
/obj/effect/spawner/random/engineering/toolbox,
/obj/effect/spawner/random/engineering/toolbox,
/obj/effect/spawner/random/engineering/tools,
/turf/template_noop,
/area/template_noop)
"z" = (
/obj/effect/spawner/random/food_trash,
/obj/effect/spawner/random/trash,
/obj/effect/spawner/random/dirt/frequent,
/turf/template_noop,
/area/template_noop)
"A" = (
/obj/effect/spawner/random/oxygen_ferry_canister,
/turf/template_noop,
/area/template_noop)
"B" = (
/obj/machinery/light/small{
	dir = 8
	},
/obj/effect/spawner/random/supply_crate/engi_atmos,
/turf/template_noop,
/area/template_noop)
"E" = (
/obj/structure/shelf/engineering,
/obj/effect/spawner/random/engineering/materials,
/obj/effect/spawner/random/engineering/materials,
/turf/template_noop,
/area/template_noop)
"G" = (
/obj/machinery/light/small{
	dir = 4
	},
/obj/structure/shelf/medbay,
/obj/effect/spawner/random/medical,
/obj/effect/spawner/random/medical,
/turf/template_noop,
/area/template_noop)
"H" = (
/obj/machinery/light/small{
	dir = 4
	},
/obj/effect/spawner/random/engineering/atmos_machine,
/turf/template_noop,
/area/template_noop)
"J" = (
/obj/effect/spawner/random/jani_supplies,
/obj/structure/shelf/service,
/turf/template_noop,
/area/template_noop)
"L" = (
/obj/effect/spawner/random/supply_crate/medical,
/turf/template_noop,
/area/template_noop)
"M" = (
/obj/machinery/light/small{
	dir = 8
	},
/obj/structure/closet/crate/trashcart,
/obj/effect/spawner/random/trash,
/obj/effect/spawner/random/pool/spaceloot/syndicate/mixed,
/obj/effect/spawner/random/maintenance,
/obj/effect/spawner/random/dirt/frequent,
/turf/template_noop,
/area/template_noop)
"N" = (
/obj/effect/map_effect/marker_helper/mapmanip/submap/edge{
	dir = 8
	},
/turf/template_noop,
/area/template_noop)
"P" = (
/obj/effect/spawner/random/dirt/frequent,
/turf/template_noop,
/area/template_noop)
"Q" = (
/obj/effect/map_effect/marker/mapmanip/submap/extract/ruin/oxygen_ferry,
/turf/template_noop,
/area/template_noop)
"T" = (
/obj/structure/closet/crate/trashcart,
/obj/effect/spawner/random/trash,
/obj/effect/spawner/random/pool/spaceloot/syndicate/mixed,
/obj/effect/spawner/random/maintenance,
/obj/effect/spawner/random/dirt/frequent,
/turf/template_noop,
/area/template_noop)
"W" = (
/obj/effect/spawner/random/engineering/atmos_machine,
/turf/template_noop,
/area/template_noop)
"X" = (
/obj/effect/spawner/random/oxygen_ferry_canister,
/obj/machinery/light/small{
	dir = 8
	},
/turf/template_noop,
/area/template_noop)
"Z" = (
/obj/machinery/light/small{
	dir = 4
	},
/obj/structure/closet/firecloset,
/turf/template_noop,
/area/template_noop)

(1,1,1) = {"
a
a
a
a
a
a
a
a
a
a
a
a
a
a
a
a
a
a
a
a
a
a
a
a
a
a
a
a
a
a
a
a
"}
(2,1,1) = {"
a
a
a
a
a
a
a
a
a
a
a
a
a
t
B
t
a
a
a
Q
a
a
a
a
A
X
A
a
a
a
q
a
"}
(3,1,1) = {"
a
a
a
a
a
a
a
a
a
a
a
a
t
t
t
t
t
a
a
a
a
a
a
A
A
A
A
A
a
a
a
a
"}
(4,1,1) = {"
a
a
a
a
a
a
a
a
a
a
a
e
p
p
m
p
p
a
a
a
a
a
e
p
p
m
p
p
a
a
a
a
"}
(5,1,1) = {"
a
a
a
a
a
a
a
a
a
a
a
a
a
a
a
a
a
a
a
a
a
a
a
A
A
A
A
A
a
a
a
a
"}
(6,1,1) = {"
a
a
a
a
a
a
a
a
a
a
a
a
a
E
i
y
a
a
a
a
a
a
a
a
W
H
W
a
a
a
a
a
"}
(7,1,1) = {"
a
a
a
a
a
a
a
a
a
a
a
a
a
a
N
a
a
a
a
a
a
a
a
a
a
N
a
a
a
a
a
a
"}
(8,1,1) = {"
a
a
a
a
a
a
a
a
a
a
a
a
a
a
a
a
a
a
a
a
a
a
a
a
a
a
a
a
a
a
a
a
"}
(9,1,1) = {"
a
a
a
a
a
a
a
a
a
a
a
a
a
a
a
a
a
a
a
a
a
a
a
a
a
a
a
a
a
a
a
a
"}
(10,1,1) = {"
a
a
a
a
a
a
a
a
a
a
a
a
a
L
o
L
a
a
a
Q
a
a
a
a
r
j
r
a
a
a
Q
a
"}
(11,1,1) = {"
a
a
a
a
a
a
a
a
a
a
a
a
L
a
a
a
a
a
a
a
a
a
a
r
r
r
r
r
a
a
a
a
"}
(12,1,1) = {"
a
a
a
a
a
a
a
a
a
a
a
e
p
p
m
p
p
a
a
a
a
a
e
p
p
m
p
p
a
a
a
a
"}
(13,1,1) = {"
a
a
a
a
a
a
a
a
a
a
a
a
L
a
a
a
a
a
a
a
a
a
a
a
a
a
a
a
a
a
a
a
"}
(14,1,1) = {"
a
a
a
a
a
a
a
a
a
a
a
a
a
n
G
n
a
a
a
a
a
a
a
a
f
Z
a
a
a
a
a
a
"}
(15,1,1) = {"
a
a
a
a
a
a
a
a
a
a
a
a
a
a
N
a
a
a
a
a
a
a
a
a
a
N
a
a
a
a
a
a
"}
(16,1,1) = {"
a
a
a
a
a
a
a
a
a
a
a
a
a
a
a
a
a
a
a
a
a
a
a
a
a
a
a
a
a
a
a
a
"}
(17,1,1) = {"
a
a
a
a
a
a
a
a
a
a
a
a
a
a
a
a
a
a
a
a
a
a
a
a
a
a
a
a
a
a
a
a
"}
(18,1,1) = {"
a
a
a
a
a
a
a
a
a
a
a
a
a
T
M
T
a
a
a
Q
a
a
a
a
a
a
a
a
a
a
a
a
"}
(19,1,1) = {"
a
a
a
a
a
a
a
a
a
a
a
a
v
P
z
P
a
a
a
a
a
a
a
a
a
a
a
a
a
a
a
a
"}
(20,1,1) = {"
a
a
a
a
a
a
a
a
a
a
a
e
b
b
s
b
b
a
a
a
a
a
a
a
a
a
a
a
a
a
a
a
"}
(21,1,1) = {"
a
a
a
a
a
a
a
a
a
a
a
a
v
P
w
P
a
a
a
a
a
a
a
a
a
a
a
a
a
a
a
a
"}
(22,1,1) = {"
a
a
a
a
a
a
a
a
a
a
a
a
a
J
h
T
a
a
a
a
a
a
a
a
a
a
a
a
a
a
a
a
"}
(23,1,1) = {"
a
a
a
a
a
a
a
a
a
a
a
a
a
a
N
a
a
a
a
a
a
a
a
a
a
a
a
a
a
a
a
a
"}
(24,1,1) = {"
a
a
a
a
a
a
a
a
a
a
a
a
a
a
a
a
a
a
a
a
a
a
a
a
a
a
a
a
a
a
a
a
"}
(25,1,1) = {"
a
a
a
a
a
a
a
a
a
a
a
a
a
a
a
a
a
a
a
a
a
a
a
a
a
a
a
a
a
a
a
a
"}
(26,1,1) = {"
a
a
a
a
a
a
a
a
a
a
a
a
a
a
a
a
a
a
a
a
a
a
a
a
a
a
a
a
a
a
a
a
"}
(27,1,1) = {"
a
a
a
a
a
a
a
a
a
a
a
a
a
a
a
a
a
a
a
a
a
a
a
a
a
a
a
a
a
a
a
a
"}
(28,1,1) = {"
a
a
a
a
a
a
a
a
a
a
a
a
a
a
a
a
a
a
a
a
a
a
a
a
a
a
a
a
a
a
a
a
"}
(29,1,1) = {"
a
a
a
a
a
a
a
a
a
a
a
a
a
a
a
a
a
a
a
a
a
a
a
a
a
a
a
a
a
a
a
a
"}
(30,1,1) = {"
a
a
a
a
a
a
a
a
a
a
a
a
a
a
a
a
a
a
a
a
a
a
a
a
a
a
a
a
a
a
a
a
"}
(31,1,1) = {"
a
a
a
a
a
a
a
a
a
a
a
a
a
a
a
a
a
a
a
a
a
a
a
a
a
a
a
a
a
a
a
a
"}
(32,1,1) = {"
a
a
a
a
a
a
a
a
a
a
a
a
a
a
a
a
a
a
a
a
a
a
a
a
a
a
a
a
a
a
a
a
"}
