//MAP CONVERTED BY dmm2tgm.py THIS HEADER COMMENT PREVENTS RECONVERSION, DO NOT REMOVE
"a" = (
/turf/simulated/floor/plasteel,
/area/game_test)
"b" = (
/obj/structure/ore_box,
/turf/simulated/floor/plasteel,
/area/game_test)
"c" = (
/obj/structure/target_stake,
/turf/space,
/turf/simulated/floor/plasteel,
/area/game_test)
"d" = (
/obj/structure/beebox,
/turf/simulated/floor/plasteel,
/area/game_test)
"e" = (
/obj/structure/bed,
/turf/simulated/floor/plasteel,
/area/game_test)
"f" = (
/obj/structure/statue/plasma/xeno,
/turf/simulated/floor/plasteel,
/area/game_test)
"g" = (
/obj/structure/cult/functional/forge,
/turf/simulated/floor/plasteel,
/area/game_test)
"h" = (
/obj/structure/windoor_assembly,
/turf/simulated/floor/plasteel,
/area/game_test)
"i" = (
/obj/structure/loom,
/turf/simulated/floor/plasteel,
/area/game_test)
"j" = (
/obj/structure/table_frame,
/turf/simulated/floor/plasteel,
/area/game_test)
"k" = (
/obj/structure/girder/cult,
/turf/simulated/floor/plasteel,
/area/game_test)
"l" = (
/obj/structure/guillotine,
/turf/simulated/floor/plasteel,
/area/game_test)
"m" = (
/obj/structure/grille,
/turf/simulated/floor/plasteel,
/area/game_test)
"n" = (
/obj/structure/shelf,
/turf/simulated/floor/plasteel,
/area/game_test)
"o" = (
/obj/structure/barricade/wooden,
/turf/simulated/floor/plasteel,
/area/game_test)
"p" = (
/obj/structure/mineral_door/iron,
/turf/simulated/floor/plasteel,
/area/game_test)
"q" = (
/obj/structure/reflector/single,
/turf/simulated/floor/plasteel,
/area/game_test)
"r" = (
/obj/structure/fermenting_barrel,
/turf/simulated/floor/plasteel,
/area/game_test)
"s" = (
/obj/structure/girder,
/turf/simulated/floor/plasteel,
/area/game_test)
"t" = (
/obj/structure/snowman,
/turf/simulated/floor/plasteel,
/area/game_test)
"u" = (
/obj/structure/machine_frame,
/turf/simulated/floor/plasteel,
/area/game_test)
"v" = (
/obj/structure/mirror,
/turf/simulated/wall/r_wall,
/area/game_test)
"w" = (
/obj/structure/extinguisher_cabinet,
/turf/simulated/wall/r_wall,
/area/game_test)
"x" = (
/turf/simulated/wall/r_wall,
/area/game_test)
"y" = (
/obj/structure/filingcabinet,
/turf/simulated/floor/plasteel,
/area/game_test)
"z" = (
/obj/structure/kitchenspike,
/turf/simulated/floor/plasteel,
/area/game_test)
"A" = (
/obj/structure/safe,
/turf/simulated/floor/plasteel,
/area/game_test)
"B" = (
/obj/effect/landmark{
	icon = 'icons/effects/spawner_icons.dmi';
	icon_state = "spooky";
	name = "Observer-Start"
	},
/obj/effect/landmark/spawner/late/crew,
/obj/effect/landmark/game_test/bottom_left_corner,
/turf/simulated/floor/plasteel,
/area/game_test)
"C" = (
/obj/structure/lattice,
/turf/simulated/floor/plasteel,
/area/game_test)
"D" = (
/obj/structure/computerframe,
/turf/simulated/floor/plasteel,
/area/game_test)
"E" = (
/obj/structure/firelock_frame,
/turf/simulated/floor/plasteel,
/area/game_test)
"F" = (
/obj/structure/noticeboard,
/turf/simulated/wall/r_wall,
/area/game_test)
"G" = (
/obj/structure/rack,
/turf/simulated/floor/plasteel,
/area/game_test)
"H" = (
/obj/structure/ai_core,
/turf/simulated/floor/plasteel,
/area/game_test)
"I" = (
/obj/structure/disposalconstruct,
/turf/simulated/floor/plating,
/area/game_test)
"J" = (
/obj/structure/particle_accelerator/fuel_chamber,
/turf/simulated/floor/plasteel,
/area/game_test)
"K" = (
/obj/structure/constructshell,
/turf/simulated/floor/plasteel,
/area/game_test)
"L" = (
/obj/structure/displaycase,
/turf/simulated/floor/plasteel,
/area/game_test)
"M" = (
/obj/structure/door_assembly,
/turf/simulated/floor/plasteel,
/area/game_test)
"N" = (
/obj/structure/clockwork/wall_gear,
/turf/simulated/floor/plasteel,
/area/game_test)
"O" = (
/obj/structure/morgue,
/turf/simulated/floor/plasteel,
/area/game_test)
"P" = (
/obj/effect/spawner/window,
/turf/simulated/floor/plasteel,
/area/game_test)
"Q" = (
/obj/effect/landmark/game_test/top_right_corner,
/turf/simulated/floor/plasteel,
/area/game_test)
"R" = (
/obj/structure/flora/ash,
/turf/simulated/floor/plasteel,
/area/game_test)
"S" = (
/obj/structure/chair,
/turf/simulated/floor/plasteel,
/area/game_test)
"U" = (
/obj/structure/kitchenspike_frame,
/turf/simulated/floor/plasteel,
/area/game_test)
"V" = (
/obj/structure/big_delivery,
/turf/simulated/floor/plasteel,
/area/game_test)
"W" = (
/obj/structure/inflatable,
/turf/simulated/floor/plasteel,
/area/game_test)
"X" = (
/obj/structure/largecrate,
/turf/simulated/floor/plasteel,
/area/game_test)
"Y" = (
/obj/structure/table,
/turf/simulated/floor/plasteel,
/area/game_test)
"Z" = (
/turf/space,
/turf/simulated/floor/plasteel,
/area/game_test)

(1,1,1) = {"
x
x
x
x
x
x
x
x
x
x
x
x
x
x
x
x
x
x
"}
(2,1,1) = {"
x
a
a
a
a
a
a
a
a
a
a
a
a
a
a
a
a
x
"}
(3,1,1) = {"
x
a
g
a
u
a
m
a
j
a
i
a
f
a
a
B
a
x
"}
(4,1,1) = {"
x
a
a
a
a
a
a
a
a
a
a
a
a
a
a
a
a
x
"}
(5,1,1) = {"
x
a
H
a
X
a
s
a
Y
a
v
a
n
a
a
a
a
x
"}
(6,1,1) = {"
x
a
a
a
a
a
a
a
a
a
a
a
a
a
a
a
a
x
"}
(7,1,1) = {"
x
a
K
a
L
a
s
a
W
a
O
a
t
a
a
a
a
x
"}
(8,1,1) = {"
x
a
a
a
a
a
a
a
a
a
a
a
a
a
a
a
a
x
"}
(9,1,1) = {"
x
a
D
a
M
a
s
a
C
a
F
a
e
a
a
a
a
x
"}
(10,1,1) = {"
x
a
a
a
a
a
a
a
a
a
a
a
a
a
a
a
a
x
"}
(11,1,1) = {"
x
a
o
a
w
a
l
a
z
a
q
a
S
a
a
a
a
x
"}
(12,1,1) = {"
x
a
a
a
a
a
a
a
a
a
a
a
a
a
a
a
a
x
"}
(13,1,1) = {"
x
a
E
a
k
a
U
a
p
a
A
a
G
a
a
a
a
x
"}
(14,1,1) = {"
x
a
Z
a
a
a
a
a
a
a
a
a
a
a
a
a
a
x
"}
(15,1,1) = {"
x
a
c
a
h
a
P
a
d
a
r
a
R
a
a
a
a
x
"}
(16,1,1) = {"
x
a
a
a
a
a
a
a
a
a
a
a
a
a
a
a
a
x
"}
(17,1,1) = {"
x
a
Q
a
y
a
b
a
V
a
N
a
J
a
I
a
a
x
"}
(18,1,1) = {"
x
a
a
a
a
a
a
a
a
a
a
a
a
a
a
a
a
x
"}
(19,1,1) = {"
x
x
x
x
x
x
x
x
x
x
x
x
x
x
x
x
x
x
"}
