//MAP CONVERTED BY dmm2tgm.py THIS HEADER COMMENT PREVENTS RECONVERSION, DO NOT REMOVE
"a" = (
/turf/simulated/floor/plasteel,
/area/game_test)
"g" = (
/obj/structure/cult/functional/forge,
/turf/simulated/floor/plasteel,
/area/game_test)
"k" = (
/obj/structure/girder/cult,
/turf/simulated/floor/plasteel,
/area/game_test)
"m" = (
/obj/structure/grille,
/turf/simulated/floor/plasteel,
/area/game_test)
"o" = (
/obj/structure/barricade/wooden,
/turf/simulated/floor/plasteel,
/area/game_test)
"u" = (
/obj/structure/machine_frame,
/turf/simulated/floor/plasteel,
/area/game_test)
"w" = (
/obj/structure/extinguisher_cabinet,
/turf/simulated/wall/r_wall,
/area/game_test)
"x" = (
/turf/simulated/wall/r_wall,
/area/game_test)
"B" = (
/obj/effect/landmark{
	icon = 'icons/effects/spawner_icons.dmi';
	icon_state = "spooky";
	name = "Observer-Start"
	},
/obj/effect/landmark/spawner/late/crew,
/obj/effect/landmark/game_test/bottom_left_corner,
/turf/simulated/floor/plasteel,
/area/game_test)
"D" = (
/obj/structure/computerframe,
/turf/simulated/floor/plasteel,
/area/game_test)
"E" = (
/obj/structure/firelock_frame,
/turf/simulated/floor/plasteel,
/area/game_test)
"H" = (
/obj/structure/ai_core,
/turf/simulated/floor/plasteel,
/area/game_test)
"K" = (
/obj/structure/constructshell,
/turf/simulated/floor/plasteel,
/area/game_test)
"L" = (
/obj/structure/displaycase,
/turf/simulated/floor/plasteel,
/area/game_test)
"M" = (
/obj/structure/door_assembly,
/turf/simulated/floor/plasteel,
/area/game_test)
"Q" = (
/obj/effect/landmark/game_test/top_right_corner,
/turf/simulated/floor/plasteel,
/area/game_test)
"X" = (
/obj/structure/largecrate,
/turf/simulated/floor/plasteel,
/area/game_test)
"Z" = (
/turf/space,
/turf/simulated/floor/plasteel,
/area/game_test)

(1,1,1) = {"
x
x
x
x
x
x
x
x
x
x
x
x
x
x
x
x
x
x
"}
(2,1,1) = {"
x
a
a
a
a
a
a
a
a
a
a
a
a
a
a
a
a
x
"}
(3,1,1) = {"
x
a
g
a
u
a
m
a
a
a
a
a
a
a
a
B
a
x
"}
(4,1,1) = {"
x
a
a
a
a
a
a
a
a
a
a
a
a
a
a
a
a
x
"}
(5,1,1) = {"
x
a
H
a
X
a
a
a
a
a
a
a
a
a
a
a
a
x
"}
(6,1,1) = {"
x
a
a
a
a
a
a
a
a
a
a
a
a
a
a
a
a
x
"}
(7,1,1) = {"
x
a
K
a
L
a
a
a
a
a
a
a
a
a
a
a
a
x
"}
(8,1,1) = {"
x
a
a
a
a
a
a
a
a
a
a
a
a
a
a
a
a
x
"}
(9,1,1) = {"
x
a
D
a
M
a
a
a
a
a
a
a
a
a
a
a
a
x
"}
(10,1,1) = {"
x
a
a
a
a
a
a
a
a
a
a
a
a
a
a
a
a
x
"}
(11,1,1) = {"
x
a
o
a
w
a
a
a
a
a
a
a
a
a
a
a
a
x
"}
(12,1,1) = {"
x
a
a
a
a
a
a
a
a
a
a
a
a
a
a
a
a
x
"}
(13,1,1) = {"
x
a
E
a
k
a
a
a
a
a
a
a
a
a
a
a
a
x
"}
(14,1,1) = {"
x
a
Z
a
a
a
a
a
a
a
a
a
a
a
a
a
a
x
"}
(15,1,1) = {"
x
a
a
a
a
a
a
a
a
a
a
a
a
a
a
a
a
x
"}
(16,1,1) = {"
x
a
Q
a
a
a
a
a
a
a
a
a
a
a
a
a
a
x
"}
(17,1,1) = {"
x
a
a
a
a
a
a
a
a
a
a
a
a
a
a
a
a
x
"}
(18,1,1) = {"
x
x
x
x
x
x
x
x
x
x
x
x
x
x
x
x
x
x
"}
