//MAP CONVERTED BY dmm2tgm.py THIS HEADER COMMENT PREVENTS RECONVERSION, DO NOT REMOVE
"a" = (
/obj/machinery/computer/arcade/orion_trail{
	dir = 1
	},
/turf/simulated/floor/carpet/arcade,
/area/template_noop)
"b" = (
/turf/simulated/floor/carpet/arcade,
/area/template_noop)
"i" = (
/obj/machinery/computer/arcade/battle{
	dir = 1
	},
/turf/simulated/floor/carpet/arcade,
/area/template_noop)
"n" = (
/obj/structure/table,
/obj/effect/spawner/random/maintenance,
/turf/simulated/floor/carpet/arcade,
/area/template_noop)
"o" = (
/obj/structure/chair/stool,
/turf/simulated/floor/carpet/arcade,
/area/template_noop)
"F" = (
/obj/machinery/computer/arcade/recruiter{
	dir = 1
	},
/turf/simulated/floor/carpet/arcade,
/area/template_noop)

(1,1,1) = {"
b
o
a
"}
(2,1,1) = {"
n
o
F
"}
(3,1,1) = {"
b
o
i
"}
