//MAP CONVERTED BY dmm2tgm.py THIS HEADER COMMENT PREVENTS RECONVERSION, DO NOT REMOVE
"a" = (
/obj/effect/spawner/random_spawners/dirt_maybe,
/turf/simulated/floor/plasteel,
/area/template_noop)
"m" = (
/obj/effect/spawner/random_spawners/dirt_maybe,
/turf/simulated/floor/plating,
/area/template_noop)

(1,1,1) = {"
m
a
a
"}
(2,1,1) = {"
a
m
m
"}
(3,1,1) = {"
m
m
a
"}
