//MAP CONVERTED BY dmm2tgm.py THIS HEADER COMMENT PREVENTS RECONVERSION, DO NOT REMOVE
"a" = (
/obj/structure/flora/grass/both,
/turf/simulated/floor/grass/jungle,
/area/template_noop)
"p" = (
/turf/simulated/floor/grass/jungle,
/area/template_noop)
"t" = (
/obj/structure/sink/puddle,
/mob/living/simple_animal/bunny,
/turf/simulated/floor/grass/jungle,
/area/template_noop)
"T" = (
/obj/structure/flora/junglebush/large{
	pixel_y = -4
	},
/turf/simulated/floor/grass/jungle,
/area/template_noop)
"W" = (
/obj/structure/flora/ausbushes/grassybush,
/turf/simulated/floor/grass/jungle,
/area/template_noop)
"Y" = (
/obj/structure/flora/ausbushes/fullgrass,
/turf/simulated/floor/grass/jungle,
/area/template_noop)

(1,1,1) = {"
p
a
T
"}
(2,1,1) = {"
T
t
Y
"}
(3,1,1) = {"
p
Y
W
"}
