//MAP CONVERTED BY dmm2tgm.py THIS HEADER COMMENT PREVENTS RECONVERSION, DO NOT REMOVE
"a" = (
/obj/effect/spawner/random_spawners/dirt_frequent,
/turf/simulated/floor/plating,
/area/template_noop)
"l" = (
/obj/effect/turf_decal/stripes/line,
/obj/structure/closet/crate/engineering,
/obj/effect/spawner/random/maintenance,
/obj/effect/spawner/random/maintenance,
/obj/effect/spawner/random_spawners/dirt_frequent,
/turf/simulated/floor/plasteel,
/area/template_noop)
"v" = (
/obj/structure/reagent_dispensers/watertank,
/obj/effect/turf_decal/stripes/line{
	dir = 6
	},
/obj/effect/spawner/random_spawners/dirt_frequent,
/turf/simulated/floor/plasteel,
/area/template_noop)
"w" = (
/obj/machinery/atmospherics/portable/canister/air,
/obj/effect/turf_decal/delivery,
/obj/effect/spawner/random_spawners/dirt_frequent,
/turf/simulated/floor/plasteel,
/area/template_noop)
"G" = (
/obj/effect/turf_decal/stripes/line{
	dir = 1
	},
/obj/item/tank/internals/emergency_oxygen/engi,
/obj/effect/spawner/random_spawners/dirt_frequent,
/turf/simulated/floor/plasteel,
/area/template_noop)
"H" = (
/obj/effect/turf_decal/stripes/line{
	dir = 5
	},
/obj/effect/spawner/random_spawners/dirt_frequent,
/turf/simulated/floor/plasteel,
/area/template_noop)
"S" = (
/obj/effect/spawner/random/trash,
/obj/effect/spawner/random_spawners/dirt_frequent,
/turf/simulated/floor/plating,
/area/template_noop)

(1,1,1) = {"
a
S
a
"}
(2,1,1) = {"
a
G
l
"}
(3,1,1) = {"
w
H
v
"}
