//MAP CONVERTED BY dmm2tgm.py THIS HEADER COMMENT PREVENTS RECONVERSION, DO NOT REMOVE
"bf" = (
/obj/structure/mirror{
	pixel_y = 28
	},
/turf/simulated/floor/clockwork,
/area/ruin/space/clockwork_site)
"bg" = (
/turf/simulated/floor/carpet/royalblack,
/area/ruin/space/clockwork_site)
"bt" = (
/obj/structure/table/reinforced/brass,
/obj/item/weldingtool/experimental/brass,
/turf/simulated/floor/clockwork,
/area/ruin/space/clockwork_site)
"ch" = (
/turf/simulated/mineral/random/high_chance,
/area/ruin/unpowered)
"cK" = (
/obj/structure/table/reinforced/brass,
/obj/item/storage/surgical_tray{
	pixel_y = 8
	},
/turf/simulated/floor/clockwork,
/area/ruin/space/clockwork_site)
"dx" = (
/turf/space,
/area/space)
"eg" = (
/obj/machinery/light/clockwork{
	dir = 1
	},
/turf/simulated/floor/clockwork,
/area/ruin/space/clockwork_site)
"ei" = (
/obj/machinery/sleeper/clockwork,
/turf/simulated/floor/clockwork,
/area/ruin/space/clockwork_site)
"gV" = (
/obj/machinery/light/clockwork/small{
	dir = 1
	},
/turf/simulated/floor/plating/asteroid/basalt,
/area/ruin/unpowered)
"hk" = (
/obj/structure/bed,
/obj/item/bedsheet/clockwork,
/obj/machinery/light/clockwork{
	dir = 4
	},
/turf/simulated/floor/clockwork,
/area/ruin/space/clockwork_site)
"hW" = (
/obj/item/clockwork/component/belligerent_eye/blind_eye,
/turf/simulated/floor/clockwork,
/area/ruin/space/clockwork_site)
"jq" = (
/turf/simulated/floor/lava/lava_land_surface/plasma,
/area/ruin/space/clockwork_site)
"jP" = (
/obj/structure/dresser,
/turf/simulated/floor/clockwork,
/area/ruin/space/clockwork_site)
"kC" = (
/obj/machinery/door/airlock/clockwork,
/turf/simulated/floor/clockwork,
/area/ruin/space/clockwork_site)
"kZ" = (
/obj/structure/bed,
/obj/item/bedsheet/clockwork,
/obj/machinery/light/clockwork,
/turf/simulated/floor/clockwork,
/area/ruin/space/clockwork_site)
"ly" = (
/obj/machinery/light/clockwork/small,
/obj/structure/chair/sofa/pew/clockwork/left{
	dir = 1
	},
/turf/simulated/floor/clockwork,
/area/ruin/space/clockwork_site)
"lN" = (
/obj/structure/chair/brass{
	dir = 8
	},
/turf/simulated/floor/clockwork,
/area/ruin/space/clockwork_site)
"mn" = (
/obj/structure/table/reinforced/brass,
/turf/simulated/floor/clockwork,
/area/ruin/space/clockwork_site)
"ow" = (
/turf/simulated/floor/plating/asteroid/basalt,
/area/ruin/unpowered)
"oW" = (
/turf/simulated/wall/clockwork,
/area/ruin/space/clockwork_site)
"pe" = (
/obj/effect/turf_decal/woodsiding{
	dir = 5
	},
/turf/simulated/floor/lava/lava_land_surface/plasma,
/area/ruin/space/clockwork_site)
"pp" = (
/obj/structure/chair/sofa/pew/clockwork{
	dir = 4
	},
/turf/simulated/floor/clockwork,
/area/ruin/space/clockwork_site)
"pE" = (
/obj/structure/bed,
/obj/item/bedsheet/clockwork,
/turf/simulated/floor/clockwork,
/area/ruin/space/clockwork_site)
"qc" = (
/obj/effect/turf_decal/woodsiding{
	dir = 6
	},
/turf/simulated/floor/lava/lava_land_surface/plasma,
/area/ruin/space/clockwork_site)
"rJ" = (
/turf/simulated/floor/clockwork,
/area/ruin/space/clockwork_site)
"rM" = (
/obj/structure/table/reinforced/brass,
/turf/simulated/floor/carpet/royalblack,
/area/ruin/space/clockwork_site)
"sg" = (
/obj/structure/shelf/clockwork,
/obj/item/clockwork/component/belligerent_eye/blind_eye,
/obj/item/clockwork/alloy_shards/pinion_lock,
/obj/item/clockwork/alloy_shards/small,
/turf/simulated/floor/clockwork,
/area/ruin/space/clockwork_site)
"sZ" = (
/obj/structure/grille/ratvar,
/obj/structure/window/reinforced/clockwork/fulltile,
/turf/simulated/floor/clockwork/reebe,
/area/ruin/space/clockwork_site)
"ua" = (
/obj/structure/chair/brass{
	dir = 4
	},
/turf/simulated/floor/clockwork,
/area/ruin/space/clockwork_site)
"uz" = (
/obj/item/clockwork/alloy_shards/clockgolem_remains,
/obj/machinery/light/clockwork/small{
	dir = 1
	},
/turf/simulated/floor/clockwork,
/area/ruin/space/clockwork_site)
"uH" = (
/obj/machinery/optable,
/turf/simulated/floor/clockwork,
/area/ruin/space/clockwork_site)
"vc" = (
/obj/structure/chair/sofa/pew/clockwork/left,
/turf/simulated/floor/clockwork,
/area/ruin/space/clockwork_site)
"vU" = (
/obj/structure/chair/sofa/pew/clockwork/right,
/turf/simulated/floor/clockwork,
/area/ruin/space/clockwork_site)
"xp" = (
/obj/effect/turf_decal/woodsiding{
	dir = 4
	},
/turf/simulated/floor/lava/lava_land_surface/plasma,
/area/ruin/space/clockwork_site)
"yn" = (
/obj/structure/table/reinforced/brass,
/obj/effect/spawner/random/food_or_drink/soup,
/turf/simulated/floor/clockwork,
/area/ruin/space/clockwork_site)
"yy" = (
/obj/structure/chair/brass{
	dir = 1
	},
/turf/simulated/floor/carpet/royalblack,
/area/ruin/space/clockwork_site)
"yH" = (
/obj/machinery/light/clockwork/small{
	dir = 4
	},
/turf/simulated/floor/clockwork,
/area/ruin/space/clockwork_site)
"zC" = (
/obj/machinery/light/clockwork{
	dir = 4
	},
/turf/simulated/floor/clockwork,
/area/ruin/space/clockwork_site)
"zQ" = (
/obj/structure/table/reinforced/brass,
/obj/item/salvage/ruin/tablet,
/turf/simulated/floor/carpet/royalblack,
/area/ruin/space/clockwork_site)
"Az" = (
/obj/structure/chair/sofa/pew/clockwork,
/turf/simulated/floor/clockwork,
/area/ruin/space/clockwork_site)
"Bo" = (
/obj/structure/window/reinforced/clockwork/fulltile,
/turf/simulated/floor/clockwork,
/area/ruin/space/clockwork_site)
"CB" = (
/obj/machinery/light/clockwork/small{
	dir = 1
	},
/turf/simulated/floor/clockwork,
/area/ruin/space/clockwork_site)
"CG" = (
/obj/machinery/light/clockwork/small{
	dir = 1
	},
/obj/structure/chair/sofa/pew/clockwork/right,
/turf/simulated/floor/clockwork,
/area/ruin/space/clockwork_site)
"CH" = (
/obj/structure/gunrack/clockwork,
/obj/item/clockwork/weapon/ratvarian_spear,
/obj/item/clockwork/weapon/ratvarian_spear,
/obj/machinery/light/clockwork/small,
/turf/simulated/floor/clockwork,
/area/ruin/space/clockwork_site)
"CI" = (
/obj/item/clockwork/alloy_shards/clockgolem_remains,
/turf/simulated/floor/clockwork,
/area/ruin/space/clockwork_site)
"CW" = (
/obj/structure/chair/brass{
	dir = 8
	},
/turf/simulated/floor/carpet/royalblack,
/area/ruin/space/clockwork_site)
"De" = (
/obj/effect/turf_decal/woodsiding{
	dir = 10
	},
/turf/simulated/floor/lava/lava_land_surface/plasma,
/area/ruin/space/clockwork_site)
"EN" = (
/obj/structure/shelf/clockwork,
/obj/item/clockwork/alloy_shards/large,
/obj/item/clockwork/component/geis_capacitor/fallen_armor,
/obj/item/clockwork/alloy_shards/medium,
/obj/item/clockwork/component/belligerent_eye,
/turf/simulated/floor/clockwork,
/area/ruin/space/clockwork_site)
"EQ" = (
/obj/structure/chair/brass{
	dir = 4
	},
/turf/simulated/floor/carpet/royalblack,
/area/ruin/space/clockwork_site)
"Gb" = (
/obj/machinery/light/clockwork/small{
	dir = 8
	},
/turf/simulated/floor/clockwork,
/area/ruin/space/clockwork_site)
"Gw" = (
/obj/structure/bed,
/obj/item/bedsheet/clockwork,
/obj/machinery/light/clockwork{
	dir = 1
	},
/turf/simulated/floor/clockwork,
/area/ruin/space/clockwork_site)
"GE" = (
/obj/structure/table/reinforced/brass,
/obj/item/stack/cable_coil/orange,
/obj/item/stack/cable_coil/orange{
	pixel_x = 2;
	pixel_y = 4
	},
/obj/item/stack/cable_coil/orange{
	pixel_x = 4;
	pixel_y = 7
	},
/obj/item/wirecutters/brass,
/turf/simulated/floor/clockwork,
/area/ruin/space/clockwork_site)
"GF" = (
/obj/structure/table/reinforced/brass,
/obj/item/crowbar/brass,
/obj/item/wrench/brass,
/turf/simulated/floor/clockwork,
/area/ruin/space/clockwork_site)
"Ht" = (
/turf/simulated/mineral/random/low_chance,
/area/ruin/unpowered)
"HB" = (
/obj/structure/chair/sofa/pew/clockwork/right{
	dir = 1
	},
/turf/simulated/floor/clockwork,
/area/ruin/space/clockwork_site)
"Ib" = (
/obj/structure/chair/brass{
	dir = 1
	},
/turf/simulated/floor/clockwork,
/area/ruin/space/clockwork_site)
"Iw" = (
/obj/structure/table/reinforced/brass,
/obj/item/tank/internals/oxygen,
/obj/item/clothing/mask/breath,
/turf/simulated/floor/clockwork,
/area/ruin/space/clockwork_site)
"IL" = (
/obj/structure/table/reinforced/brass,
/obj/item/storage/belt/utility,
/obj/item/screwdriver/brass,
/turf/simulated/floor/clockwork,
/area/ruin/space/clockwork_site)
"Jm" = (
/turf/simulated/floor/chasm/space_ruin,
/area/ruin/unpowered)
"Jx" = (
/obj/structure/chair/brass,
/turf/simulated/floor/clockwork,
/area/ruin/space/clockwork_site)
"Ki" = (
/obj/machinery/light/clockwork/small,
/turf/simulated/floor/clockwork,
/area/ruin/space/clockwork_site)
"Ku" = (
/obj/structure/table/reinforced/brass,
/obj/item/paper_bin{
	pixel_y = 4
	},
/obj/item/pen/multi/fountain,
/turf/simulated/floor/carpet/royalblack,
/area/ruin/space/clockwork_site)
"KZ" = (
/obj/structure/chair/sofa/pew/clockwork{
	dir = 1
	},
/turf/simulated/floor/clockwork,
/area/ruin/space/clockwork_site)
"Lh" = (
/obj/structure/clockwork/wall_gear,
/obj/machinery/light/clockwork/floor,
/turf/simulated/floor/clockwork,
/area/ruin/space/clockwork_site)
"Mc" = (
/obj/effect/turf_decal/woodsiding{
	dir = 8
	},
/turf/simulated/floor/lava/lava_land_surface/plasma,
/area/ruin/space/clockwork_site)
"ME" = (
/obj/machinery/light/clockwork,
/turf/simulated/floor/clockwork,
/area/ruin/space/clockwork_site)
"MU" = (
/obj/structure/chair/brass,
/turf/simulated/floor/carpet/royalblack,
/area/ruin/space/clockwork_site)
"NC" = (
/obj/structure/table/reinforced/brass,
/obj/item/stack/tile/brass/fifty,
/turf/simulated/floor/clockwork,
/area/ruin/space/clockwork_site)
"NF" = (
/obj/structure/chair/sofa/pew/clockwork/left{
	dir = 4
	},
/turf/simulated/floor/clockwork,
/area/ruin/space/clockwork_site)
"NQ" = (
/obj/structure/shelf/clockwork,
/obj/effect/spawner/random/maintenance,
/turf/simulated/floor/clockwork,
/area/ruin/space/clockwork_site)
"NV" = (
/obj/item/clockwork/component/geis_capacitor/fallen_armor,
/turf/simulated/floor/clockwork,
/area/ruin/space/clockwork_site)
"Pp" = (
/obj/structure/clockwork/wall_gear,
/turf/simulated/floor/clockwork,
/area/ruin/space/clockwork_site)
"Rv" = (
/obj/machinery/light/clockwork{
	dir = 8
	},
/turf/simulated/floor/clockwork,
/area/ruin/space/clockwork_site)
"Rw" = (
/obj/structure/table/reinforced/brass,
/obj/item/paper/clockwork_cult_message,
/turf/simulated/floor/carpet/royalblack,
/area/ruin/space/clockwork_site)
"RD" = (
/mob/living/simple_animal/hostile/clockwork_construct/clockwork_marauder/hostile{
	dir = 1
	},
/turf/simulated/floor/clockwork,
/area/ruin/space/clockwork_site)
"Tr" = (
/obj/machinery/computer/operating/clockwork,
/turf/simulated/floor/clockwork,
/area/ruin/space/clockwork_site)
"Vh" = (
/obj/effect/turf_decal/woodsiding{
	dir = 9
	},
/turf/simulated/floor/lava/lava_land_surface/plasma,
/area/ruin/space/clockwork_site)
"VU" = (
/obj/structure/table/reinforced/brass,
/obj/item/clockwork/alloy_shards{
	pixel_y = 3
	},
/turf/simulated/floor/clockwork,
/area/ruin/space/clockwork_site)
"WR" = (
/mob/living/simple_animal/hostile/clockwork_construct/clockwork_marauder/hostile,
/turf/simulated/floor/clockwork,
/area/ruin/space/clockwork_site)
"Yx" = (
/obj/structure/chair/sofa/pew/clockwork/right{
	dir = 4
	},
/turf/simulated/floor/clockwork,
/area/ruin/space/clockwork_site)
"YX" = (
/obj/structure/table/reinforced/brass,
/obj/item/storage/firstaid/adv,
/turf/simulated/floor/clockwork,
/area/ruin/space/clockwork_site)
"Zz" = (
/obj/structure/shelf/clockwork,
/obj/item/reagent_containers/glass/bottle/copper,
/obj/item/reagent_containers/glass/bottle/copper,
/obj/item/reagent_containers/glass/bottle/copper,
/obj/item/reagent_containers/glass/bottle/copper,
/obj/item/reagent_containers/glass/bottle/copper,
/obj/item/reagent_containers/glass/bottle/copper,
/obj/machinery/light/clockwork/small,
/turf/simulated/floor/clockwork,
/area/ruin/space/clockwork_site)

(1,1,1) = {"
dx
dx
dx
dx
dx
dx
dx
dx
dx
dx
dx
dx
dx
dx
dx
dx
dx
dx
dx
dx
dx
dx
dx
dx
dx
dx
dx
dx
dx
dx
dx
dx
dx
dx
dx
dx
dx
dx
dx
dx
dx
dx
dx
dx
dx
dx
dx
dx
dx
dx
dx
dx
dx
dx
dx
dx
dx
dx
"}
(2,1,1) = {"
dx
dx
dx
dx
dx
dx
dx
dx
dx
dx
dx
dx
dx
dx
dx
dx
dx
dx
dx
dx
dx
dx
dx
dx
Ht
Ht
Ht
Ht
Ht
Ht
Ht
Ht
Ht
dx
dx
dx
dx
dx
dx
dx
dx
dx
dx
dx
dx
dx
dx
dx
dx
dx
dx
dx
dx
dx
dx
dx
dx
dx
"}
(3,1,1) = {"
dx
dx
dx
dx
dx
dx
dx
dx
dx
dx
dx
dx
dx
dx
dx
dx
dx
dx
dx
dx
dx
dx
Ht
Ht
Ht
Ht
Ht
Ht
Ht
Ht
Ht
Ht
Ht
dx
dx
dx
dx
dx
dx
dx
dx
dx
dx
dx
dx
dx
dx
dx
dx
dx
dx
dx
dx
dx
dx
dx
dx
dx
"}
(4,1,1) = {"
dx
dx
dx
dx
dx
dx
dx
dx
dx
dx
dx
dx
dx
dx
dx
dx
dx
dx
Ht
Ht
Ht
Ht
Ht
Ht
Ht
Ht
Ht
Ht
Ht
Ht
Ht
Ht
Ht
Ht
Ht
Ht
dx
dx
dx
dx
dx
dx
dx
dx
dx
dx
dx
dx
dx
dx
dx
dx
dx
dx
dx
dx
dx
dx
"}
(5,1,1) = {"
dx
dx
dx
dx
dx
dx
dx
dx
dx
dx
dx
dx
dx
dx
dx
Ht
Ht
Ht
Ht
Ht
Ht
Ht
Ht
Ht
Ht
oW
oW
oW
oW
oW
oW
oW
Ht
Ht
Ht
Ht
dx
dx
dx
dx
dx
dx
dx
dx
dx
dx
Ht
Ht
dx
dx
dx
dx
dx
dx
dx
dx
dx
dx
"}
(6,1,1) = {"
dx
dx
dx
dx
dx
dx
dx
dx
dx
dx
dx
dx
dx
dx
dx
Ht
Ht
Ht
Ht
Ht
Ht
Ht
Ht
Ht
oW
oW
Rv
rJ
rJ
rJ
Rv
oW
oW
Ht
Ht
Ht
Ht
Ht
Ht
Ht
dx
dx
dx
Ht
Ht
Ht
Ht
Ht
dx
dx
dx
dx
dx
dx
dx
dx
dx
dx
"}
(7,1,1) = {"
dx
dx
dx
dx
dx
dx
dx
dx
dx
dx
dx
dx
dx
dx
Ht
Ht
Ht
Ht
Ht
Ht
Ht
Ht
Ht
Ht
oW
rJ
rJ
rJ
rJ
rJ
rJ
rJ
oW
Ht
Ht
Ht
Ht
Ht
Ht
Ht
Ht
Ht
dx
Ht
Ht
Ht
Ht
Ht
Ht
Ht
dx
dx
dx
dx
dx
dx
dx
dx
"}
(8,1,1) = {"
dx
dx
dx
dx
dx
dx
dx
dx
dx
dx
dx
dx
dx
dx
Ht
Ht
Ht
Ht
Ht
Ht
Ht
Ht
Ht
Ht
oW
eg
rJ
bg
EQ
bg
rJ
ME
oW
Ht
Ht
Ht
Ht
Ht
Ht
Ht
Ht
Ht
Ht
Ht
Ht
Ht
Ht
Ht
Ht
Ht
Ht
dx
dx
dx
dx
dx
dx
dx
"}
(9,1,1) = {"
dx
dx
dx
dx
dx
dx
dx
dx
dx
dx
dx
dx
Ht
Ht
Ht
Ht
Ht
Ht
oW
oW
oW
oW
Ht
Ht
oW
rJ
rJ
MU
rM
yy
rJ
rJ
oW
Ht
Ht
Ht
Ht
Ht
Ht
Ht
Ht
Ht
Ht
Ht
Ht
Ht
Ht
Ht
Ht
Ht
Ht
dx
dx
dx
dx
dx
dx
dx
"}
(10,1,1) = {"
dx
dx
dx
dx
dx
dx
dx
dx
dx
dx
dx
dx
Ht
Ht
Ht
Ht
Ht
oW
oW
NV
NV
oW
oW
Ht
oW
rJ
rJ
MU
Rw
yy
rJ
rJ
oW
Ht
oW
oW
oW
oW
oW
oW
Ht
Ht
Ht
Ht
Ht
Ht
Ht
Ht
Ht
Ht
Ht
dx
dx
dx
dx
dx
dx
dx
"}
(11,1,1) = {"
dx
dx
dx
dx
dx
dx
dx
dx
dx
dx
Ht
Ht
Ht
Ht
Ht
Ht
oW
oW
Bo
Bo
Bo
Bo
oW
oW
oW
eg
rJ
MU
Ku
yy
rJ
ME
oW
oW
oW
Yx
pp
pp
NF
oW
oW
Ht
Ht
Ht
Ht
Ht
Ht
Ht
Ht
Ht
dx
dx
dx
dx
dx
dx
dx
dx
"}
(12,1,1) = {"
dx
dx
dx
dx
dx
dx
dx
dx
dx
dx
Ht
Ht
Ht
Ht
Ht
oW
oW
CB
rJ
rJ
rJ
rJ
Ki
oW
oW
rJ
rJ
MU
zQ
yy
rJ
rJ
oW
oW
CB
rJ
rJ
rJ
rJ
Ki
oW
oW
Ht
Ht
Ht
Ht
Ht
Ht
Ht
Ht
Ht
Ht
dx
dx
dx
dx
dx
dx
"}
(13,1,1) = {"
dx
dx
dx
dx
dx
dx
dx
dx
dx
dx
Ht
Ht
Ht
Ht
oW
oW
Bo
rJ
rJ
rJ
rJ
rJ
rJ
rJ
kC
rJ
rJ
MU
rM
yy
rJ
rJ
oW
vc
rJ
rJ
rJ
rJ
rJ
rJ
HB
oW
Ht
Ht
Ht
Ht
Ht
Ht
Ht
Ht
Ht
Ht
dx
dx
dx
dx
dx
dx
"}
(14,1,1) = {"
dx
dx
dx
dx
dx
dx
dx
dx
dx
dx
Ht
Ht
Ht
Ht
oW
hW
Bo
rJ
rJ
rJ
rJ
rJ
rJ
rJ
oW
eg
rJ
bg
CW
bg
rJ
ME
oW
Az
rJ
rJ
bg
bg
rJ
rJ
KZ
oW
Ht
Ht
Ht
Ht
Ht
Ht
Ht
Ht
Ht
Ht
Ht
dx
dx
dx
dx
dx
"}
(15,1,1) = {"
dx
dx
dx
dx
dx
dx
dx
dx
dx
dx
Ht
Ht
Ht
Ht
oW
uz
Bo
rJ
rJ
rJ
rJ
rJ
rJ
rJ
oW
rJ
rJ
rJ
rJ
rJ
rJ
rJ
oW
Az
rJ
rJ
bg
bg
rJ
rJ
KZ
oW
Ht
Ht
Ht
Ht
Ht
Ht
Ht
Ht
Ht
Ht
Ht
dx
dx
dx
dx
dx
"}
(16,1,1) = {"
dx
dx
dx
dx
dx
Ht
Ht
Ht
Ht
Ht
Ht
Ht
Ht
Ht
oW
CI
Bo
rJ
rJ
rJ
rJ
rJ
rJ
Ki
oW
oW
rJ
rJ
rJ
rJ
rJ
oW
oW
CG
rJ
rJ
rJ
rJ
rJ
rJ
ly
oW
Ht
Ht
Ht
Ht
Ht
Ht
Ht
Ht
Ht
Ht
Ht
dx
dx
dx
dx
dx
"}
(17,1,1) = {"
dx
dx
dx
Ht
Ht
Ht
Ht
Ht
Ht
Ht
Ht
Ht
Ht
Ht
oW
oW
Bo
rJ
rJ
rJ
rJ
rJ
rJ
Bo
Bo
oW
oW
Bo
kC
Bo
oW
oW
Bo
Bo
rJ
rJ
rJ
rJ
rJ
rJ
oW
oW
oW
oW
oW
oW
oW
oW
oW
Ht
Ht
Ht
Ht
Ht
dx
dx
dx
dx
"}
(18,1,1) = {"
dx
dx
dx
Ht
Ht
Ht
Ht
Ht
Ht
Ht
Ht
Ht
Ht
Ht
Ht
oW
rJ
rJ
rJ
rJ
rJ
rJ
Bo
Bo
WR
rJ
Rv
rJ
rJ
rJ
Rv
rJ
WR
Bo
Bo
rJ
rJ
rJ
yH
rJ
oW
rJ
rJ
Rv
rJ
rJ
Rv
mn
oW
oW
ch
ch
ch
Ht
Ht
Ht
dx
dx
"}
(19,1,1) = {"
dx
dx
dx
Ht
Ht
Ht
Ht
Ht
Ht
Ht
Ht
Ht
Ht
oW
oW
oW
oW
oW
oW
oW
rJ
Bo
Bo
rJ
rJ
rJ
rJ
rJ
rJ
rJ
rJ
rJ
rJ
rJ
Bo
Bo
rJ
rJ
oW
kC
oW
rJ
rJ
rJ
vc
rJ
rJ
rJ
mn
oW
gV
ch
ch
ch
ch
Ht
Ht
dx
"}
(20,1,1) = {"
dx
dx
dx
oW
oW
oW
oW
oW
oW
oW
oW
oW
oW
oW
Rv
rJ
rJ
rJ
Rv
oW
Bo
Bo
rJ
rJ
Pp
rJ
rJ
rJ
Pp
rJ
rJ
rJ
Pp
rJ
rJ
Bo
Bo
oW
oW
rJ
rJ
rJ
vc
rJ
Az
rJ
rJ
rJ
rJ
sZ
ow
ch
ch
Jm
ch
ch
Ht
dx
"}
(21,1,1) = {"
dx
dx
oW
oW
Lh
Iw
Lh
Iw
Lh
rJ
Lh
oW
oW
rJ
rJ
bg
bg
bg
rJ
rJ
oW
rJ
rJ
rJ
rJ
rJ
rJ
rJ
rJ
rJ
rJ
rJ
rJ
rJ
rJ
rJ
oW
oW
rJ
rJ
vc
rJ
Az
rJ
Az
rJ
rJ
rJ
rJ
sZ
ow
Jm
Jm
Jm
ch
ch
Ht
dx
"}
(22,1,1) = {"
dx
oW
oW
rJ
rJ
rJ
rJ
rJ
rJ
rJ
rJ
rJ
oW
rJ
bg
bg
bg
bg
bg
WR
oW
rJ
rJ
rJ
rJ
rJ
Vh
Mc
Mc
Mc
De
rJ
rJ
rJ
rJ
rJ
oW
RD
rJ
rJ
vU
rJ
vU
rJ
vU
RD
rJ
rJ
rJ
sZ
ow
Jm
Jm
Jm
Jm
ch
Ht
dx
"}
(23,1,1) = {"
dx
kC
rJ
rJ
rJ
rJ
rJ
rJ
rJ
rJ
rJ
rJ
kC
rJ
bg
bg
bg
bg
bg
rJ
kC
rJ
rJ
rJ
rJ
Vh
jq
jq
jq
jq
jq
De
rJ
rJ
rJ
rJ
kC
bg
bg
bg
bg
bg
bg
bg
bg
bg
rM
rJ
rJ
sZ
ow
Jm
Jm
Jm
Jm
Jm
Ht
dx
"}
(24,1,1) = {"
dx
kC
rJ
rJ
rJ
rJ
rJ
rJ
rJ
rJ
rJ
rJ
kC
rJ
bg
bg
bg
bg
bg
rJ
kC
rJ
rJ
rJ
rJ
pe
jq
jq
jq
jq
jq
qc
rJ
rJ
rJ
rJ
kC
bg
bg
bg
bg
bg
bg
bg
bg
bg
rM
rJ
rJ
sZ
ow
Jm
Jm
Jm
Jm
Jm
Ht
dx
"}
(25,1,1) = {"
dx
oW
oW
rJ
rJ
rJ
rJ
rJ
rJ
rJ
rJ
rJ
oW
rJ
bg
bg
bg
bg
bg
WR
oW
rJ
rJ
rJ
rJ
rJ
pe
xp
xp
xp
qc
rJ
rJ
rJ
rJ
rJ
oW
RD
rJ
rJ
vc
rJ
vc
rJ
vc
RD
rJ
rJ
rJ
sZ
ow
Jm
Jm
Jm
Jm
Jm
Ht
dx
"}
(26,1,1) = {"
dx
dx
oW
oW
Lh
Iw
Lh
Iw
Lh
rJ
Lh
oW
oW
rJ
rJ
bg
bg
bg
rJ
rJ
oW
rJ
rJ
rJ
rJ
rJ
rJ
rJ
rJ
rJ
rJ
rJ
rJ
rJ
rJ
rJ
oW
oW
rJ
rJ
vU
rJ
Az
rJ
Az
rJ
rJ
rJ
rJ
sZ
ow
Jm
Jm
Jm
ch
ch
Ht
dx
"}
(27,1,1) = {"
dx
dx
dx
oW
oW
oW
oW
oW
oW
oW
oW
oW
oW
oW
zC
rJ
rJ
rJ
zC
oW
Bo
Bo
rJ
rJ
Pp
rJ
rJ
rJ
Pp
rJ
rJ
rJ
Pp
rJ
rJ
Bo
Bo
oW
oW
rJ
rJ
rJ
vU
rJ
Az
rJ
rJ
rJ
rJ
sZ
ow
ch
Jm
Jm
ch
ch
Ht
dx
"}
(28,1,1) = {"
dx
dx
dx
dx
Ht
Ht
Ht
Ht
Ht
Ht
Ht
Ht
Ht
oW
oW
oW
oW
oW
oW
oW
rJ
Bo
Bo
rJ
rJ
rJ
rJ
rJ
rJ
rJ
rJ
rJ
rJ
rJ
Bo
Bo
rJ
rJ
oW
kC
oW
rJ
rJ
rJ
vU
rJ
rJ
rJ
mn
oW
gV
ch
ch
ch
ch
ch
Ht
dx
"}
(29,1,1) = {"
dx
dx
dx
dx
Ht
Ht
Ht
Ht
Ht
Ht
Ht
Ht
Ht
Ht
Ht
oW
rJ
rJ
rJ
rJ
rJ
rJ
Bo
Bo
WR
rJ
zC
rJ
rJ
rJ
zC
rJ
WR
Bo
Bo
rJ
rJ
rJ
Gb
rJ
oW
rJ
rJ
zC
rJ
rJ
zC
mn
oW
oW
ch
ch
ch
Ht
ch
ch
Ht
dx
"}
(30,1,1) = {"
dx
dx
dx
dx
dx
dx
dx
dx
Ht
Ht
Ht
Ht
Ht
Ht
oW
oW
rJ
rJ
rJ
rJ
rJ
rJ
rJ
Bo
Bo
oW
oW
Bo
kC
Bo
oW
oW
Bo
Bo
rJ
rJ
rJ
rJ
rJ
rJ
oW
oW
oW
oW
oW
oW
oW
oW
oW
Ht
Ht
Ht
Ht
Ht
Ht
Ht
Ht
dx
"}
(31,1,1) = {"
dx
dx
dx
dx
dx
dx
dx
dx
Ht
Ht
Ht
Ht
Ht
Ht
oW
NQ
rJ
rJ
rJ
ua
ua
rJ
rJ
Zz
oW
oW
Rv
rJ
rJ
rJ
Rv
oW
oW
rJ
rJ
rJ
rJ
rJ
rJ
rJ
cK
oW
Ht
Ht
Ht
Ht
Ht
Ht
Ht
Ht
Ht
Ht
Ht
Ht
Ht
dx
dx
dx
"}
(32,1,1) = {"
dx
dx
dx
dx
dx
dx
dx
dx
Ht
Ht
Ht
Ht
Ht
Ht
oW
CB
rJ
rJ
Jx
mn
VU
rJ
rJ
sg
oW
rJ
rJ
rJ
rJ
rJ
rJ
rJ
oW
CB
rJ
rJ
bg
bg
rJ
rJ
Ki
oW
Ht
Ht
Ht
Ht
Ht
Ht
Ht
Ht
Ht
Ht
Ht
dx
dx
dx
dx
dx
"}
(33,1,1) = {"
dx
dx
dx
dx
dx
dx
dx
dx
dx
dx
Ht
Ht
Ht
Ht
oW
NC
rJ
rJ
Jx
mn
mn
rJ
rJ
EN
oW
eg
rJ
ua
ua
ua
rJ
ME
oW
rJ
rJ
rJ
bg
bg
rJ
rJ
rJ
oW
Ht
Ht
Ht
Ht
Ht
Ht
Ht
Ht
Ht
Ht
Ht
dx
dx
dx
dx
dx
"}
(34,1,1) = {"
dx
dx
dx
dx
dx
dx
dx
dx
dx
dx
Ht
Ht
Ht
Ht
oW
oW
rJ
rJ
rJ
rJ
rJ
rJ
rJ
rJ
kC
rJ
Jx
yn
yn
yn
Ib
rJ
oW
rJ
rJ
rJ
rJ
rJ
rJ
rJ
YX
oW
Ht
Ht
Ht
Ht
Ht
Ht
Ht
Ht
Ht
dx
dx
dx
dx
dx
dx
dx
"}
(35,1,1) = {"
dx
dx
dx
dx
dx
dx
dx
dx
dx
dx
dx
dx
Ht
Ht
Ht
oW
oW
rJ
rJ
rJ
rJ
rJ
CH
oW
oW
rJ
Jx
yn
yn
yn
Ib
rJ
oW
oW
CB
rJ
rJ
rJ
rJ
Ki
oW
oW
Ht
Ht
Ht
Ht
Ht
Ht
Ht
Ht
dx
dx
dx
dx
dx
dx
dx
dx
"}
(36,1,1) = {"
dx
dx
dx
dx
dx
dx
dx
dx
dx
dx
dx
dx
dx
Ht
Ht
Ht
oW
oW
GE
rJ
rJ
GF
oW
oW
oW
rJ
rJ
lN
lN
lN
rJ
rJ
oW
oW
oW
ei
uH
Tr
ei
oW
oW
Ht
Ht
Ht
Ht
Ht
Ht
Ht
Ht
Ht
Ht
dx
dx
dx
dx
dx
dx
dx
"}
(37,1,1) = {"
dx
dx
dx
dx
dx
dx
dx
dx
dx
dx
dx
dx
dx
Ht
Ht
Ht
Ht
oW
oW
bt
IL
oW
oW
Ht
oW
bf
rJ
rJ
rJ
rJ
rJ
rJ
oW
Ht
oW
oW
oW
oW
oW
oW
Ht
Ht
Ht
Ht
Ht
Ht
Ht
Ht
Ht
Ht
Ht
dx
dx
dx
dx
dx
dx
dx
"}
(38,1,1) = {"
dx
dx
dx
dx
dx
dx
dx
dx
dx
dx
dx
dx
dx
Ht
Ht
Ht
Ht
Ht
oW
oW
oW
oW
Ht
Ht
oW
bf
rJ
rJ
rJ
rJ
rJ
rJ
oW
Ht
Ht
Ht
Ht
Ht
Ht
Ht
Ht
Ht
Ht
Ht
Ht
Ht
Ht
Ht
Ht
Ht
Ht
dx
dx
dx
dx
dx
dx
dx
"}
(39,1,1) = {"
dx
dx
dx
dx
dx
dx
dx
dx
dx
dx
dx
dx
dx
dx
Ht
Ht
Ht
Ht
Ht
Ht
Ht
Ht
Ht
Ht
oW
Gw
rJ
rJ
rJ
rJ
rJ
kZ
oW
Ht
Ht
Ht
Ht
Ht
Ht
Ht
Ht
Ht
Ht
Ht
Ht
Ht
Ht
Ht
Ht
Ht
dx
dx
dx
dx
dx
dx
dx
dx
"}
(40,1,1) = {"
dx
dx
dx
dx
dx
dx
dx
dx
dx
dx
dx
dx
dx
dx
Ht
Ht
Ht
Ht
Ht
Ht
Ht
Ht
Ht
Ht
oW
jP
rJ
rJ
rJ
rJ
rJ
jP
oW
Ht
Ht
Ht
Ht
Ht
Ht
Ht
Ht
Ht
Ht
Ht
Ht
Ht
Ht
Ht
Ht
Ht
dx
dx
dx
dx
dx
dx
dx
dx
"}
(41,1,1) = {"
dx
dx
dx
dx
dx
dx
dx
dx
dx
dx
dx
dx
dx
dx
dx
dx
Ht
Ht
Ht
Ht
Ht
Ht
Ht
Ht
oW
oW
pE
jP
hk
jP
pE
oW
oW
Ht
Ht
Ht
Ht
Ht
Ht
Ht
Ht
Ht
Ht
Ht
Ht
Ht
Ht
Ht
dx
dx
dx
dx
dx
dx
dx
dx
dx
dx
"}
(42,1,1) = {"
dx
dx
dx
dx
dx
dx
dx
dx
dx
dx
dx
dx
dx
dx
dx
dx
dx
dx
Ht
Ht
Ht
Ht
Ht
Ht
Ht
oW
oW
oW
oW
oW
oW
oW
Ht
Ht
Ht
Ht
Ht
dx
Ht
Ht
Ht
Ht
Ht
Ht
Ht
Ht
Ht
Ht
dx
dx
dx
dx
dx
dx
dx
dx
dx
dx
"}
(43,1,1) = {"
dx
dx
dx
dx
dx
dx
dx
dx
dx
dx
dx
dx
dx
dx
dx
dx
dx
dx
dx
dx
dx
dx
Ht
Ht
Ht
Ht
Ht
Ht
Ht
Ht
Ht
Ht
Ht
Ht
dx
dx
dx
dx
dx
dx
dx
dx
dx
Ht
Ht
Ht
dx
dx
dx
dx
dx
dx
dx
dx
dx
dx
dx
dx
"}
(44,1,1) = {"
dx
dx
dx
dx
dx
dx
dx
dx
dx
dx
dx
dx
dx
dx
dx
dx
dx
dx
dx
dx
dx
dx
dx
dx
Ht
Ht
Ht
Ht
Ht
Ht
Ht
Ht
dx
dx
dx
dx
dx
dx
dx
dx
dx
dx
dx
Ht
Ht
Ht
dx
dx
dx
dx
dx
dx
dx
dx
dx
dx
dx
dx
"}
(45,1,1) = {"
dx
dx
dx
dx
dx
dx
dx
dx
dx
dx
dx
dx
dx
dx
dx
dx
dx
dx
dx
dx
dx
dx
dx
dx
Ht
Ht
Ht
Ht
Ht
Ht
Ht
dx
dx
dx
dx
dx
dx
dx
dx
dx
dx
dx
dx
dx
dx
dx
dx
dx
dx
dx
dx
dx
dx
dx
dx
dx
dx
dx
"}
(46,1,1) = {"
dx
dx
dx
dx
dx
dx
dx
dx
dx
dx
dx
dx
dx
dx
dx
dx
dx
dx
dx
dx
dx
dx
dx
dx
dx
dx
dx
dx
dx
dx
dx
dx
dx
dx
dx
dx
dx
dx
dx
dx
dx
dx
dx
dx
dx
dx
dx
dx
dx
dx
dx
dx
dx
dx
dx
dx
dx
dx
"}
