//MAP CONVERTED BY dmm2tgm.py THIS HEADER COMMENT PREVENTS RECONVERSION, DO NOT REMOVE
"a" = (
/turf/template_noop,
/area/template_noop)
"g" = (
/obj/machinery/atmospherics/pipe/simple/visible{
	dir = 4
	},
/turf/simulated/floor/plating,
/area/ruin/space/powered)
"l" = (
/mob/living/carbon/human/monkey/punpun,
/turf/simulated/floor/plating,
/area/ruin/space/powered)
"w" = (
/turf/simulated/floor/plating,
/area/ruin/space/powered)
"F" = (
/obj/machinery/atmospherics/unary/portables_connector{
	dir = 4
	},
/obj/machinery/atmospherics/portable/canister/oxygen,
/turf/simulated/floor/plating,
/area/ruin/space/powered)
"Q" = (
/obj/machinery/atmospherics/pipe/manifold/visible,
/turf/simulated/floor/plating,
/area/ruin/space/powered)
"S" = (
/turf/simulated/wall,
/area/template_noop)
"T" = (
/obj/machinery/atmospherics/pipe/simple/visible{
	dir = 10
	},
/turf/simulated/floor/plating,
/area/ruin/space/powered)

(1,1,1) = {"
a
a
a
a
a
a
a
a
a
a
"}
(2,1,1) = {"
a
a
a
a
a
a
a
a
a
a
"}
(3,1,1) = {"
a
a
S
S
S
S
S
S
a
a
"}
(4,1,1) = {"
a
a
S
w
F
w
w
S
a
a
"}
(5,1,1) = {"
a
a
S
w
g
w
w
S
a
a
"}
(6,1,1) = {"
a
a
S
T
Q
l
w
S
a
a
"}
(7,1,1) = {"
a
a
S
w
g
w
w
S
a
a
"}
(8,1,1) = {"
a
a
S
S
S
S
S
S
a
a
"}
(9,1,1) = {"
a
a
a
a
a
a
a
a
a
a
"}
(10,1,1) = {"
a
a
a
a
a
a
a
a
a
a
"}
