//MAP CONVERTED BY dmm2tgm.py THIS HEADER COMMENT PREVENTS RECONVERSION, DO NOT REMOVE
"a" = (
/turf/simulated/wall,
/area/ruin/space/powered)
"g" = (
/turf/template_noop,
/area/template_noop)
"x" = (
/turf/simulated/floor/plasteel,
/area/ruin/space/powered)
"E" = (
/turf/simulated/mineral,
/area/ruin/space/powered)

(1,1,1) = {"
g
g
g
g
g
g
g
g
g
g
g
g
g
g
g
g
g
g
g
g
g
g
g
g
g
g
g
g
g
g
g
g
g
g
g
g
g
g
"}
(2,1,1) = {"
g
g
g
g
g
g
g
g
g
g
g
g
g
g
g
g
g
g
g
g
g
g
g
g
g
g
g
g
g
g
g
E
g
g
g
g
g
g
"}
(3,1,1) = {"
g
g
g
g
g
g
g
g
g
g
g
g
g
g
g
g
g
g
E
E
E
E
E
E
E
E
g
g
g
g
E
E
g
g
g
g
g
g
"}
(4,1,1) = {"
g
g
g
g
E
E
E
E
E
g
g
g
g
g
g
g
E
E
E
E
E
E
E
E
E
E
E
E
E
E
E
E
E
g
g
g
g
g
"}
(5,1,1) = {"
g
g
g
E
E
E
E
E
E
E
E
g
E
E
E
E
E
E
E
E
E
E
E
E
E
E
E
E
E
E
E
E
E
g
g
g
g
g
"}
(6,1,1) = {"
g
g
g
E
E
E
E
E
E
E
E
E
E
E
E
E
E
E
E
E
E
E
E
E
E
E
E
E
E
E
E
E
E
g
g
g
g
g
"}
(7,1,1) = {"
g
g
g
E
E
E
a
a
a
a
a
a
a
a
a
a
a
a
a
a
a
a
a
a
a
a
a
a
a
a
E
E
E
E
g
g
g
g
"}
(8,1,1) = {"
g
g
E
E
E
E
a
x
x
x
x
x
x
x
x
x
x
x
x
x
x
x
x
x
x
x
x
x
x
a
E
E
E
E
g
g
g
g
"}
(9,1,1) = {"
g
g
E
E
E
E
a
x
x
x
x
x
x
x
x
x
x
x
x
x
x
x
x
x
x
x
x
x
x
a
E
E
E
E
g
g
g
g
"}
(10,1,1) = {"
g
E
E
E
E
E
a
x
x
x
x
x
a
x
x
a
a
a
a
a
x
x
a
a
a
a
a
x
x
a
a
a
a
E
g
g
g
g
"}
(11,1,1) = {"
g
E
E
E
E
E
a
x
x
x
x
x
a
x
x
a
x
x
x
a
x
x
a
x
x
x
a
x
x
x
x
x
a
E
g
g
g
g
"}
(12,1,1) = {"
g
E
E
E
E
E
a
x
x
x
x
x
a
x
x
a
x
x
x
a
x
x
a
x
x
x
a
x
x
x
x
x
a
E
g
g
g
g
"}
(13,1,1) = {"
g
E
E
E
E
E
a
x
x
x
x
x
a
x
x
a
x
x
x
a
x
x
a
x
x
x
a
a
a
a
x
x
a
E
g
g
g
g
"}
(14,1,1) = {"
g
E
E
E
E
E
a
x
x
x
x
x
a
x
x
a
x
x
x
a
x
x
a
x
x
x
a
x
x
a
x
x
a
E
g
g
g
g
"}
(15,1,1) = {"
g
E
E
E
E
E
a
x
x
x
x
x
a
x
x
x
x
x
x
x
x
x
x
x
x
x
x
x
x
x
x
x
a
E
g
g
g
g
"}
(16,1,1) = {"
g
g
E
E
E
E
a
x
x
x
x
x
a
x
x
x
x
x
x
x
x
x
x
x
x
x
x
x
x
x
x
x
a
E
g
g
g
g
"}
(17,1,1) = {"
g
g
E
a
a
a
a
a
a
a
a
a
a
x
x
a
x
x
x
a
x
x
a
x
x
x
a
x
x
a
x
x
a
E
E
g
g
g
"}
(18,1,1) = {"
g
g
E
a
x
x
x
x
x
a
x
x
x
x
x
a
x
x
x
a
x
x
a
x
x
x
a
x
x
a
x
x
a
a
E
E
E
g
"}
(19,1,1) = {"
g
g
E
a
x
x
x
x
x
a
x
x
x
x
x
a
x
x
x
a
x
x
a
x
x
x
a
x
x
a
x
x
x
a
E
E
E
g
"}
(20,1,1) = {"
g
E
E
a
x
x
x
x
x
a
x
x
a
a
a
a
a
a
a
a
x
x
a
a
a
a
a
a
a
a
x
x
x
a
E
E
E
g
"}
(21,1,1) = {"
g
E
E
a
x
x
x
x
x
a
x
x
a
g
g
g
g
g
g
a
x
x
a
g
g
g
g
a
x
x
x
x
x
a
E
E
g
g
"}
(22,1,1) = {"
g
E
E
a
a
a
a
x
x
a
x
x
a
a
a
a
a
a
a
a
x
x
a
a
a
a
a
a
x
x
x
x
x
a
E
E
g
g
"}
(23,1,1) = {"
g
E
E
a
x
x
x
x
x
x
x
x
x
x
x
x
x
x
x
x
x
x
x
x
x
x
x
x
x
x
x
x
x
x
x
x
g
g
"}
(24,1,1) = {"
g
E
E
a
x
x
x
x
x
x
x
x
x
x
x
x
x
x
x
x
x
x
x
x
x
x
x
x
x
x
x
x
x
x
x
x
g
g
"}
(25,1,1) = {"
g
g
E
a
x
x
x
x
x
a
x
x
a
a
a
a
a
a
a
a
x
x
a
a
a
a
a
a
x
x
a
x
x
a
E
E
g
g
"}
(26,1,1) = {"
g
g
E
a
x
x
x
x
a
a
x
x
a
g
g
g
g
g
a
x
x
x
x
x
a
x
x
x
x
x
a
x
x
a
E
E
g
g
"}
(27,1,1) = {"
g
g
E
a
x
x
x
x
a
x
x
x
a
a
a
a
a
a
a
x
x
x
x
x
a
x
x
x
x
x
a
x
x
a
E
E
E
g
"}
(28,1,1) = {"
g
g
E
a
x
x
x
x
a
x
x
x
x
x
x
x
x
x
a
x
x
x
x
x
a
x
x
x
x
x
a
x
x
a
E
E
E
g
"}
(29,1,1) = {"
g
g
E
a
x
x
a
a
a
a
x
x
x
x
x
x
x
x
a
x
x
x
x
x
a
x
x
x
x
x
a
x
x
a
E
E
E
g
"}
(30,1,1) = {"
g
g
E
a
a
a
a
x
x
a
a
a
a
a
a
a
x
x
a
a
a
x
a
a
a
a
a
x
a
a
a
x
x
a
E
E
g
g
"}
(31,1,1) = {"
g
g
E
E
E
E
a
x
x
x
x
x
x
x
x
a
x
x
x
x
x
x
x
x
x
x
x
x
x
x
x
x
x
a
E
E
g
g
"}
(32,1,1) = {"
g
g
g
E
E
E
a
x
x
x
x
x
x
x
x
a
x
x
x
x
x
x
x
x
x
x
x
x
x
x
x
x
x
a
E
g
g
g
"}
(33,1,1) = {"
g
g
g
g
E
E
a
x
x
x
x
x
x
x
x
a
a
x
x
a
a
x
a
a
a
x
a
a
a
a
a
a
a
a
E
g
g
g
"}
(34,1,1) = {"
g
g
g
g
E
E
a
x
x
x
x
x
x
x
x
x
x
x
x
a
x
x
x
a
x
x
x
a
E
E
E
E
E
E
E
g
g
g
"}
(35,1,1) = {"
g
g
g
g
E
E
a
x
x
x
x
x
x
x
x
x
x
x
x
a
x
x
x
a
x
x
x
a
E
E
E
g
E
E
g
g
g
g
"}
(36,1,1) = {"
g
g
g
g
g
E
a
a
a
a
a
a
a
a
a
a
a
a
a
a
a
a
a
a
a
a
a
a
E
E
g
g
g
g
g
g
g
g
"}
(37,1,1) = {"
g
g
g
g
g
E
E
E
E
E
E
E
E
E
E
E
E
E
E
E
E
E
E
E
E
E
E
E
E
g
g
g
g
g
g
g
g
g
"}
(38,1,1) = {"
g
g
g
g
g
g
g
E
E
E
E
E
E
E
E
E
g
E
E
E
E
E
E
E
g
g
E
E
g
g
g
g
g
g
g
g
g
g
"}
(39,1,1) = {"
g
g
g
g
g
g
g
g
g
g
g
g
g
g
g
g
g
g
g
E
E
E
E
g
g
g
g
g
g
g
g
g
g
g
g
g
g
g
"}
(40,1,1) = {"
g
g
g
g
g
g
g
g
g
g
g
g
g
g
g
g
g
g
g
g
g
g
g
g
g
g
g
g
g
g
g
g
g
g
g
g
g
g
"}
