//MAP CONVERTED BY dmm2tgm.py THIS HEADER COMMENT PREVENTS RECONVERSION, DO NOT REMOVE
"v" = (
/obj/item/paper,
/turf/simulated,
/area/station/public/dorms)
"x" = (
/obj/item/crowbar,
/obj/item/paper,
/turf/simulated,
/area/station/public/dorms)
"S" = (
/obj/item/multitool,
/turf/simulated,
/area/station/public/dorms)

(1,1,1) = {"
v
x
"}
(2,1,1) = {"
S
S
"}
